1111111111111112211111100000001111111111
1111111001111112211111110000001111111111
1111100011111112211111111111111111111111
1111000111111112211111111111111111111111
3333333333331111221111111111111111111111
1111111111131111122111111111111111111111
1111111111131111112211111111111111111111
1111111111333111112211111111111111111111
1111222111333333333333333333331111111111
1112222211333111112211111111111111111111
1111222111111111122111111111111111111111
1110112222222222221111111111111111111111
1110111111122111111111111111111111111111
1110111111221111111111111111111111111111
1110001112211110000001111111111111111111
1110000000000000000011111111111111111111
1111111112211110000111111111111111111111
1111111100221111111111111111111111111111
1111111110122111111111111111111111111111
1111111111112211111111111111111111111111
-
3,3,10,house.map,3,8
6,19,11,Merchant,npcs/merchant.png,merchant.npc
0,3,10
5,0,0
4,1,12,0,1
4,1,14,1,1
4,1,16,0,1
4,3,14,2,1
4,3,16,3,1
1,7,1
1,7,3
1,7,5
1,7,7