0000000000000000000000000000000000000000
0222221112222223322222211111112222222220
0222111222222213322222222222222222222220
0221122222222233222222222222222222222220
0333333333332222332222222222222222222220
0222222222132222133222222222222222222220
0222222222132222223322222222222222222220
0222222222333222213322222222222222222220
0222222221333333333333333333332222222220
0212222222333222213322222222222222222220
0222332222222222233222222222222222222220
0212223333333333332222222222222222222220
0212222222133222222222222222222222222220
0212222222332222222222222222222222222220
0211122213322221111112222222222222222220
0211111111111111111122222222222222222220
0222222213322221111222222222222222222220
0222222211332222222222222222222222222220
0222222211133222222222222222222222222220
0000000000000000000000000000000000000000
-
3,3,10,house.map,3,8
3,3,18,dungeon.map,10,1
6,15,14,Merchant,npcs/merchant.png,merchant.npc
6,23,11,Nam,npcs/nam.png,nam.npc
4,3,14,4,1
0,3,10,100
5,1,0
1,7,1
1,7,3
1,7,5
1,7,7
1,15,10