1111111111111112211111100000001111111111
1111111001111112211111110000001111111111
1111100011111112211111111111111111111111
1111000111111112211111111111111111111111
3333333333331111221111111111111111111111
1111111111131111122111111111111111111111
1111111111131111112211111111111111111111
1111111111333111112211111111111111111111
1111222111333333333333333333331111111111
1112222211333111112211111111111111111111
1111222111111111122111111111111111111111
1111112222222222221111111111111111111111
1111111111122111111111111111111111111111
1111100011221111111111111111111111111111
1111100112211110000001111111111111111111
1111111112211100000011111111111111111111
1111111112211110000111111111111111111111
1111111100221111111111111111111111111111
1111111110122111111111111111111111111111
1111111111112211111111111111111111111111
-
3,3,3,house.map,0,8
4,1,4,0,1
4,3,4,0,1
4,5,4,0,1
4,7,4,1,1
4,9,4,2,1
0,5,5
1,7,2
1,1,10
1,12,1
1,14,9
1,12,1
1,13,12
1,20,9
1,22,1
1,24,12
1,2,8
1,15,15
1,17,1
1,1,15